10,20
####################
##  # ##         ###
#  #     ## # ##  ##
# #  # ##       #  #
#   #  #  # # #  # #
# ##E##  # #  #S#  #
#       # #  # #  ##
# # # #  #  #    # #
#      #   #  # # ##
####################
